 ###################
 #........#........# 
 #o##.###.#.###.##o# 
 #.................#
 #.##.#.#####.#.##.#
 #....#...#...#....#
 ####.### # ###.####
    #.#   0   #.#   
#####.# ##=## #.#####
     .  #123#  .     
#####.# ##### #.#####
    #.#       #.#    
 ####.# ##### #.#### 
 #........#........# 
 #.##.###.#.###.##.# 
 #o.#.....P.....#.o# 
 ##.#.#.#####.#.#.## 
 #....#...#...#....# 
 #.######.#.######.# 
 #.................# 
 ###################